########
#@   $.#
#### ###
  #  #.#
  # $  #
  #    #
  ######
