########
#@   $.#
#### ###
  #  #.#
  ##$  #
  #    #
  #    #
  ##$ ##
   #.##
   ###
