######## ######
#.#@   ###    #
#.## $$    $  #
#.##  $$# $ $ #
#.##    #     #
#.#######$#####
#.#    #      #
#.######      #
#  ....*$$$   #
#  #####      #
####   ########
